20
16
11111111111111111111
10000000000000000001
10000000000000000001
10000000000000000001
10000000000000000001
10000000000000000001
10000000000000000001
10000000000000000001
10200000000000000001
10200000000000000001
10200000000000000001
10200000000000000001
10200011111000000001
12222222221000000001
1s000000001000000001
11111111111111111111