21
19
111111111111111111111
100002222222222200001
101012121212121210101
100000000000000000001
121212121212121212121
122222222222222222221
121212121212121212121
122222222222222222221
121212121212121212121
122222222222222222221
121212121212121212121
122222222222222222221
121212121212121212121
122222222222222222221
121212121212121212121
100000000000000000001
101012121212121210101
1s0022222222222200001
111111111111111111111