21
19
111111111111111111111
100000000000000000001
101010101010101010101
100000000000000000001
101010101010101010101
100000000000000000001
101010101010101010101
100000000000000000001
101010101010101010101
100000000000000000001
101010101010101010101
100000000000000000001
101010101010101010101
100000000000000000001
101010101010101010101
102000000000000000001
101212121210101010101
1s0020000000000000001
111111111111111111111